WWWWWWWWWWWWWWWWWWWW
W....FI..WW........W
W.WWWWWW.W..W.WWWW.W
W.W........WWIWF...W
W..WW.W.WW.WW.WW..WW
W.W.W.......W......W
W.W.WWW.FWW.W.W.WI.W
W.W.W.WWWWWWW.W.WWWW
W........FW...WF..IW
W.WIW.WW.WWW.WW.W.WW
W.WWWFWW.WWW.W..W.WW
W....W...WW....WF..W
W.W.WWWW..G.W.WWWW.W
W.W...W..WW.W.W....W
W.W.W.W.WWW.WFW.WWWW
W.W.W.....W...W...WW
W.W.WWW.IWW.W...WI.W
W.W.WIWWWW..W.W.WW.W
W..................W
WWWWWWWWWWWWWWWWWWWW
