WWWWWWWWWWWWWWWWWWWW
W....WI..WW...GW...W
W.WWWWWW.W..W.WWWW.W
W.W...W....WWIWF...W
W...W.W.WW.WW.WW..WW
W.W.W.......W.W....W
W.W.WWW.FWW.W.W.WI.W
W.W.W.WWWWWWW.W.WWWW
W........FW...W...IW
W.WIW.WW.WWW.WW.W.WW
W.WWWFWW.WWW.W..W.WW
W....W...WW....WF..W
W.WWWWWW....W.WWWW.W
W.W...W..WW.W.W....W
W.W.W.W.WWW.WIW.WWWW
W.WFW.....W...W...WW
W.W.WWW.IWW.W...WI.W
W.W.WIWWWW..W.W.WW.W
W.......IWF........W
WWWWWWWWWWWWWWWWWWWW
