WWWWWWWWWWWWWWWWWWWW
W...FWI..WW....WG..W
W.WWWWWW.W..WWWWWW.W
W.W...W..W.WWIWF...W
W.W.W.W.WW.WW.WWW.WW
W.W.W.......W.W....W
W.W.WWW.FWW.W.W.W.IW
W.W.W.WWWWW.W.W.WWWW
W........FW...W...IW
W.WIWFWW.WWW.WWWW.WW
W.WWWWWW.WWW.W.WW.WW
W....W...WW....WF..W
W.WWWWWW....W.WWWW.W
W.W...W.EWW.W.W....W
W.W.W.W.WWW.WIW.WWWW
W.W.W.....W.W.W...WW
W.W.WWW.IWW.W...WI.W
W.W.WIWWWW..WWW.WW.W
W.......FWF........W
WWWWWWWWWWWWWWWWWWWW
